################
#       X      #
#              #
#              #
#              #
#              #
#              #
#              #
#   o          #
#              #
# o d o        #
#              #
#   o          #
#        C     #
#@             #
################
